11111111
10000P01
1C000011
1000C001
100100C1
10010C01
1E010001
11111111
